NO ./assets/wolf1.png
SO ./assets/wolf1.png
WE ./assets/wolf1.png
EA ./assets/wolf1.png

C 255,255,255
F 255,255,255

                                                                     1111
                                                                     1001
                                                                    11001
                                                                    10101
                                                                   111101
                                                                   101101
                                                                   111011
                                                                  111111
                                                                  101101
                                                                 1111101
                                                                 101 111
                                                               11111 101
                                                               101  1111
                                                              1111  101                                                                    111
                                                              101   111                                                                    101
                                                              111   101                                                                   1101
                                                                    111                                                                  11001
                                                             111   111                                                11111             110001
                                                             101   101            1111                                100011            100101
                                                             111   111           110011              111              101001           1101101
                                                           111     101          1100001              101              1011011          1001101
                                                           101     111         110011011             1011            110111011         1011101
                                                           111    111         11011110011           11001           11011 10011       1101 101
               111                                        111     101         1001  110011          100011          1001  110011      1011 1011
              1101                                        101     111         1011   110011         1010011         1011   110011    1101  1001
              1011                                        111    111          101     1100111      11011001        1101     11001    1011  1101
              111                                        111     101          101      1110011     100111011       1001      1101   1101    101
             1101                                        101     111          101        111011    1011 1001       1011       1011  1001    1011
             1011                                        111    111           101          11011  1101  11011     1101        1001 11011    1001
            1101                                        111     101           1011          1101 11011   1001    11011        110111011     1101
            1011                                        101     111           1101           10111001    11011   1001          1011001       101
            101                                         111    111             101           10011011     11011 11011          1011011       101
           1111                                        111     101             1011          1101011       100111001           101011        101
          1101                                         101     111             1001           10101        110100111           10001         101
          1011                                         111                     1101           10011         100011             10011         1011
          111                                         111     111               101           1001          11111              1011          1001
 111     1101                                         101     101               101           1111                             111           1101
 10111   1011                                        1111     111               101                                                           101
 10001111111                                         101     111                101                                                       111 1011
 11010101011111                                     1111     101                101                                                      1101 1001
  1011111101101111111                               101      111                101        111                     111         111       1001 11011
  101  10111111101101111111                         111     111                 101        101                     101       11101      11011  1001
  101  111     111111101101111                      101     101                 101        101                     1011    1110011     11011   1101
  101 1101           11111110111111                 101     111                 101  111111101111                  11011  1100111      1001     101
  101 1011                 1111010111              1111                         101  100000000001    111111111111   10011110111       11011     101
  101 111                     111110111111111      1001    111                  101  111111011111    100000000001   110000011        11001      101
  111111                          111101011011111  1011    101                  101       101        111111111111   111000011       110011      101
  101101                             11111111010111101     111                  101       101                       1001110011     110011       101
 1101011                                    1111101001    111                   101       101                       1011 11001     10011        101
 101011                                         111111    101                  1101       111                       111   1111    11011         101
 11111                                                    111                  1001                                               1001          101
 10001                                                   111                   1011                                               1111          101
 10111                                                   101                   101                                                             1101
1101                                                     111                   101                                                             1001
1001                                                     111                   101                                                             1011
1111                                                     101                   101                                                            1101
                                                        1111                   1011                                                           1001
                                                        101                    1101                                                           1011
                                                       1111                     101                                                           101
                                                       101                      101                                           11111111111111  101
                                                       111                      10111111111111111111111111111111111111111111111000000000000111101
                                                      1101                      10100000000000000000000000000000000000000000000111111111110000001
                                                      1011                      111111111111111111111111111111111111111111111111         11111111
                                                      101
                                                      101
                                                      111
