NO ./sprites/beds.png
WE ./sprites/campus.png
SO ./sprites/cluster.png
EA ./sprites/lobby.png

C 225,30,0
F 225,30,22

		1111111111111111111111111  
		1000000000110000000000001  
		1011000001110000000000001  
		1001000000000000000000001  
111111111011000001110000000000001  
100000000011000001110111111111111  
11110111111111011100000010001         111
11110111111111011101010010001         101
11000000110101011100000010001         101
10000000000000001100000010001         101
10000000000000001101010010001         111
11000001110101011111011110N0111
11110111111101011101111010001
11111111111111111111111111111

		11111
		10001
		11111